NO ./textures/dungeonTexture.png
SO ./textures/dungeonTexture.png
WE ./textures/dungeonTexture.png
EA ./textures/dungeonTexture.png

C 93,142,193
F 231,230,230







1111111111111
1111011111111
1111011111111
1100000011011
1000000000001
1000000N00001
1111111111111