NO ./textures/colorstone.png
SO ./textures/colorstone.png
WE ./textures/colorstone.png
EA ./textures/colorstone.png

C 93,142 ,     103
F 231,230,230

111111
100101
101S01
100001
111011
111011
100001
101001
100001
111011
111011
101001
100001
111011
111011
100001
101001
100001
100001
111011
101001
100001
111011
111011
111011
111011
101001
100001
111011
111011
101001
100001
111011
111011
100001
101001
100001
100001
111011
101001
100001
111011
111011
111011
111011
101001
100001
111011
111011
101001
100001
111011
111011
100001
101001
100001
100001
111011
101001
100001
111011
111011
111011
111011
101001
100001
111011
111011
101001
100001
111011
111011
100001
101001
100001
100001
111011
101001
100001
111011
111011
111011
111011
101001
100001
111011
111011
100001
101001
100001
100001
111011
111011
100001
101001
100001
111011
111011
111011
111011
111011
111011
101001
100001
111011
111011
101001
100001
111011
111011
100001
101001
100001
100001
111011
111011
100001
101001
100001
111011
111011
100001
101001
100001
111011
111011
100001
101001
100001
111011
111011
100001
101001
100001
111011
111011
100001
101001
100001
111011
111011
100001
101001
100001
111011
111011
100001
101001
100001
100001
111011
111011
100001
101001
100001
111011
111011
100001
101001
100001
111011
111011
100001
101001
100001
111011
111011
100001
101001
100001
100001
111011
111011
100001
101001
100001
111011
111011
100001
101001
100001
100101
101001
100001
111011
111011
100001
101001
100001
111011
111011
101001
100001
111011
111011
100001
101001
100001
100001
111011
101001
100001
111011
111011
111011
111011
101001
100001
111011
111011
101001
100001
111011
111011
100001
101001
100001
100001
111011
101001
100001
111011
111011
111011
111011
101001
100001
111011
111011
101001
100001
111011
111011
100001
101001
100001
100001
111011
101001
100001
111011
111011
111011
111011
101001
100001
111011
111011
101001
100001
111011
111011
100001
101001
100001
100001
111011
101001
100001
111011
111011
111011
111011
101001
100001
111011
111011
100001
101001
100001
100001
111011
111011
100001
101001
100001
111011
111011
111011
111011
111011
111011
101001
100001
111011
111011
101001
100001
111011
111011
100001
101001
100001
100001
111011
111011
100001
101001
100001
111011
111011
100001
101001
100001
111011
111011
100001
101001
100001
111011
111011
100001
101001
100001
111011
111011
100001
101001
100001
111011
111011
100001
101001
100001
111011
111011
100001
101001
100001
100001
111011
111011
100001
101001
100001
111011
111011
100001
101001
100001
111011
111011
100001
101001
100001
111011
111011
100001
101001
100001
100001
111011
111011
100001
101001
100001
111011
111011
100001
101001
100001
100101
101001
100001
111011
111011
100001
101001
100001
111011
111011
101001
100001
111011
111011
100001
101001
100001
100001
111011
101001
100001
111011
111011
111011
111011
101001
100001
111011
111011
101001
100001
111011
111011
100001
101001
100001
100001
111011
101001
100001
111011
111011
111011
111011
101001
100001
111011
111011
101001
100001
111011
111011
100001
101001
100001
100001
111011
101001
100001
111011
111011
111011
111011
101001
100001
111011
111011
101001
100001
111011
111011
100001
101001
100001
100001
111011
101001
100001
111011
111011
111011
111011
101001
100001
111011
111011
100001
101001
100001
100001
111011
111011
100001
101001
100001
111011
111011
111011
111011
111011
111011
101001
100001
111011
111011
101001
100001
111011
111011
100001
101001
100001
100001
111011
111011
100001
101001
100001
111011
111011
100001
101001
100001
111011
111011
100001
101001
100001
111011
111011
100001
101001
100001
111011
111011
100001
101001
100001
111011
111011
100001
101001
100001
111011
111011
100001
101001
100001
100001
111011
111011
100001
101001
100001
111011
111011
100001
101001
100001
111011
111011
100001
101001
100001
111011
111011
100001
101001
100001
100001
111011
111011
100001
101001
100001
111011
111011
100001
101001
100001
100101
101001
100001
111011
111011
100001
101001
100001
111011
111011
101001
100001
111011
111011
100001
101001
100001
100001
111011
101001
100001
111011
111011
111011
111011
101001
100001
111011
111011
101001
100001
111011
111011
100001
101001
100001
100001
111011
101001
100001
111011
111011
111011
111011
101001
100001
111011
111011
101001
100001
111011
111011
100001
101001
100001
100001
111011
101001
100001
111011
111011
111011
111011
101001
100001
111011
111011
101001
100001
111011
111011
100001
101001
100001
100001
111011
101001
100001
111011
111011
111011
111011
101001
100001
111011
111011
100001
101001
100001
100001
111011
111011
100001
101001
100001
111011
111011
111011
111011
111011
111011
101001
100001
111011
111011
101001
100001
111011
111011
100001
101001
100001
100001
111011
111011
100001
101001
100001
111011
111011
100001
101001
100001
111011
111011
100001
101001
100001
111011
111011
100001
101001
100001
111011
111011
100001
101001
100001
111011
111011
100001
101001
100001
111011
111011
100001
101001
100001
100001
111011
111011
100001
101001
100001
111011
111011
100001
101001
100001
111011
111011
100001
101001
100001
111011
111011
100001
101001
100001
100001
111011
111011
100001
101001
100001
111011
111011
100001
101001
100001
100101
101001
100001
111011
111011
100001
101001
100001
111011
111011
101001
100001
111011
111011
100001
101001
100001
100001
111011
101001
100001
111011
111011
111011
111011
101001
100001
111011
111011
101001
100001
111011
111011
100001
101001
100001
100001
111011
101001
100001
111011
111011
111011
111011
101001
100001
111011
111011
101001
100001
111011
111011
100001
101001
100001
100001
111011
101001
100001
111011
111011
111011
111011
101001
100001
111011
111011
101001
100001
111011
111011
100001
101001
100001
100001
111011
101001
100001
111011
111011
111011
111011
101001
100001
111011
111011
100001
101001
100001
100001
111011
111011
100001
101001
100001
111011
111011
111011
111011
111011
111011
101001
100001
111011
111011
101001
100001
111011
111011
100001
101001
100001
100001
111011
111011
100001
101001
100001
111011
111011
100001
101001
100001
111011
111011
100001
101001
100001
111011
111011
100001
101001
100001
111011
111011
100001
101001
100001
111011
111011
100001
101001
100001
111011
111011
100001
101001
100001
100001
111011
111011
100001
101001
100001
111011
111011
100001
101001
100001
111011
111011
100001
101001
100001
111011
111011
100001
101001
100001
100001
111011
111011
100001
101001
100001
111011
111011
100001
101001
100001
111111