NO ./textures/bricks.png
SO ./textures/bricks.png
WE ./textures/brick.png
EA ./textures/brick.png


F 65,152,10
C 137,207,240


        1111111111111111111111111
        1000000000110000000000001
        101100000011000000W000001
        1001000000110000000000001
111111111011000001110000000000001
100000000011000001111100111111111
11110111111111011100001000001
11110111111111011101011110001
11000000110101011101000010001
10001110000000000001000010001
10000000000000000001010010001
11111111111111111111011110001
                 100000000001
                 111111111111