NO ./textures/bricks.png
SO ./textures/bricks.png
WE ./textures/brick.png
EA ./textures/brick.png


F 65,152,10
C 135,206,235

1111111111111
1111011111111
1111011111111
1100000011011
1000000000001
1000000000001
1000000W00001
1111111111111