NO ./textures/bricks.png
SO ./textures/bricks.png
WE ./textures/brick.png
EA ./textures/brick.png


F 65,152,10
C 135,206,235


111111111111111111111111111111111
100000000100000000000000000000001
100000000100000000000000000000001
100000000100000000000000000000001
111111111100000000000000000000001
100000000000000000000000000000001
100000000000000000000000000000001
10000E000000000000000000000000001
100000000000000000000000000000001
100000000000000Y00000000000000001
100000000000000000000000000000001
100000000000000000000000000000001
100000000000000000000000000000001
111111111111111111111111111111111